rose	rose_wine
strawberry	strawberry_wine
bilberry	bilberry_wine
passion_fruit	passion_fruit_wine
plum	plum_wine
sherry	sherry_wine
scotch	scotch_whiskey
malt	malt_whiskey
pear	pear_brandy
fruit	fruit_brandy
grape	grape_brandy
anise	anise_brandy
cherry	cherry_brandy
blackberry	blackberry_brandy
rum	rum_brandy
plum	plum_brandy
apple	apple_brandy
raspberry	raspberry_brandy
brandy	rum_brandy
brandy	cherry_brandy